[
  [2, 2, 2, 2, 2, 2, 2, 2, 2, 2, 2, 2, 2, 2, 2, 2, 2, 2],
  [2, 2, 2, 2, 2, 2, 2, 2, 2, 2, 2, 1, 2, 2, 2, 2, 2, 2],
  [2, "P", 1, 1, 1, "P", 1, 1, 2, 2, 2, 1, 2, 2, "P", 0, 0, 2],
  [2, 2, 0, 0, 0, 0, 0, 0, 0, 0, 0, 0, 0, 0, 0, "S", 0, 2],
  [2, 2, 0, 2, 2, 2, 1, 2, 2, 2, 2, 2, 2, 1, 0, 0, 0, 2],
  [2, 2, 0, 2, 1, 1, 1, 1, 2, 2, 2, 1, 2, 1, 2, 1, 2, 2],
  [2, 2, 0, 2, 2, 1, 1, 1, 1, 2, 1, 1, 2, 1, 2, 1, 2, 2],
  [2, 2, 0, 1, 1, 1, 2, 2, 1, 2, 2, 1, 2, 1, 2, 1, 2, 2],
  [2, 2, 0, 2, 2, 1, 2, 2, 1, 2, 2, 1, 1, 1, 1, 1, 2, 2],
  [2, 2, 0, 1, 1, 1, "P", 1, 1, 1, 2, 2, 1, 2, 2, 2, 2, 2],
  [2, 2, 0, 2, 2, 2, 1, 1, 2, 1, 2, 2, 1, 2, 2, 2, 2, 2],
  [2, 2, 0, 2, 2, 1, 1, 2, 2, "P", 2, 2, 1, 1, 1, "P", 2, 2],
  [2, 2, 0, 2, 2, 1, 2, 2, 2, 2, 2, 2, 2, 2, 1, 1, 2, 2],
  [2, "P", 0, 2, 2, 1, 2, 2, 2, 2, 2, 2, 2, 2, 1, 2, 2, 2],
  [2, 0, 0, 1, 1, 1, 1, 2, 2, 2, 2, 2, 2, 1, 1, 2, 2, 2],
  [2, "E", 2, 2, 1, 2, 1, 1, 1, "P", 2, 2, 2, 1, 2, 2, 2, 2],
  [2, 2, 2, 2, "P", 2, 2, 2, 2, 2, 2, 2, 2, "P", 2, 2, 2, 2],
  [2, 2, 2, 2, 2, 2, 2, 2, 2, 2, 2, 2, 2, 2, 2, 2, 2, 2]
]
